%%%%%%%%%%%%%%%%%%%%
%....%...  ...%....%
%.%%.%.%%  %%.%.%%.%
%.%....      ....%.%
%.%%.%.%%%%%%.%.%%.%
%...... 3    ......%
%.%%...%%%%%%...%%.%
%.%..%...  ...%..%.%
%.%%.%.%%%%%%.%.%%.%
%......    4 ......%
% %%%%%%%%%%%%%%%% %
%        %%        %
%%%%%% %%%%%% %%%%%%
%%%%%%  1%% 2 %%%%%%
%%%%%%%%%%%%%%%%%%%%
